//MAP CONVERTED BY dmm2tgm.py THIS HEADER COMMENT PREVENTS RECONVERSION, DO NOT REMOVE
"a" = (
/turf/open/water/deep_beach/lethal,
/area/space)
"i" = (
/turf/open/misc/beach/sand,
/area/space)
"l" = (
/obj/item/storage/toolbox/drone{
	pixel_x = 3;
	pixel_y = -1
	},
/turf/open/indestructible/hotelwood,
/area/space)
"p" = (
/turf/open/misc/grass,
/area/space)
"v" = (
/obj/effect/landmark/deathmatch_player_spawn,
/turf/open/misc/sandy_dirt,
/area/space)
"x" = (
/turf/open/indestructible/hotelwood,
/area/space)
"A" = (
/obj/structure/flora/tree/palm,
/turf/open/misc/grass,
/area/space)
"C" = (
/turf/open/misc/sandy_dirt,
/area/space)
"G" = (
/obj/machinery/syndicatebomb{
	active = 1;
	timer_set = 420
	},
/obj/item/stack/cable_coil/cut,
/turf/open/indestructible/hotelwood,
/area/space)
"I" = (
/turf/open/water/beach,
/area/space)
"J" = (
/obj/item/clothing/gloves/color/yellow,
/turf/open/indestructible/hotelwood,
/area/space)
"K" = (
/obj/effect/landmark/deathmatch_player_spawn,
/turf/open/water/beach,
/area/space)
"M" = (
/obj/structure/flora/tree/palm/style_2,
/turf/open/misc/grass,
/area/space)
"N" = (
/obj/structure/mineral_door/wood,
/turf/open/indestructible/hotelwood,
/area/space)
"T" = (
/turf/closed/wall{
	icon = 'modular_meta/features/deathmatch/icons/island_operation.dmi'
	},
/area/space)

(1,1,1) = {"
a
a
a
a
a
a
a
a
a
a
a
a
a
a
a
a
a
a
a
a
a
a
a
a
a
a
a
a
a
a
a
a
a
a
a
a
a
a
a
a
"}
(2,1,1) = {"
a
a
a
a
a
a
a
a
a
a
a
a
a
a
a
a
a
a
a
a
a
a
a
a
a
a
a
a
a
a
a
a
a
a
a
a
a
a
a
a
"}
(3,1,1) = {"
a
a
a
a
a
a
a
a
a
a
a
a
a
a
a
a
a
a
a
a
a
a
a
a
a
a
a
a
a
a
a
a
a
a
a
a
a
a
a
a
"}
(4,1,1) = {"
a
a
a
a
a
a
a
a
a
a
a
a
a
a
a
a
a
a
a
a
a
a
a
a
a
a
a
a
a
a
a
a
a
a
a
a
a
a
a
a
"}
(5,1,1) = {"
a
a
a
a
a
a
a
a
a
a
a
a
a
I
I
I
I
I
I
I
I
I
I
I
I
I
I
I
a
a
a
a
a
a
a
a
a
a
a
a
"}
(6,1,1) = {"
a
a
a
a
a
a
I
I
I
I
I
I
I
I
I
I
I
I
I
K
I
I
I
I
I
I
I
I
I
I
I
a
a
a
a
a
a
a
a
a
"}
(7,1,1) = {"
a
a
a
a
a
I
I
I
I
I
I
I
I
I
I
I
I
I
I
I
I
I
I
I
I
I
i
i
i
I
I
I
I
a
a
a
a
a
a
a
"}
(8,1,1) = {"
a
a
a
a
a
I
I
K
I
I
I
I
I
I
I
I
I
I
I
I
I
I
I
i
i
i
i
i
i
I
I
I
I
a
a
a
a
a
a
a
"}
(9,1,1) = {"
a
a
a
a
I
I
I
I
I
I
I
I
i
i
i
i
i
i
i
i
i
i
i
i
i
i
i
i
i
i
I
I
I
a
a
a
a
a
a
a
"}
(10,1,1) = {"
a
a
a
a
I
I
I
I
i
i
i
i
i
i
i
i
i
i
i
i
i
i
i
i
i
i
i
i
i
i
I
I
I
I
a
a
a
a
a
a
"}
(11,1,1) = {"
a
a
a
a
I
I
I
i
i
i
i
i
i
p
p
p
p
p
p
p
p
p
p
i
i
i
i
i
i
i
I
I
I
I
a
a
a
a
a
a
"}
(12,1,1) = {"
a
a
a
a
I
I
I
i
i
i
p
p
p
p
p
p
A
p
p
M
p
p
M
p
p
p
i
i
i
i
I
I
I
I
a
a
a
a
a
a
"}
(13,1,1) = {"
a
a
a
a
I
I
i
i
i
p
p
p
M
p
p
p
p
p
p
p
p
p
p
p
p
p
p
i
i
i
I
I
I
I
a
a
a
a
a
a
"}
(14,1,1) = {"
a
a
a
a
I
I
i
i
p
p
p
p
p
p
M
p
p
M
p
p
M
p
p
M
p
p
p
i
i
i
I
I
K
I
a
a
a
a
a
a
"}
(15,1,1) = {"
a
a
a
a
I
I
i
i
p
M
p
A
p
p
p
p
p
p
p
p
p
p
p
p
p
M
p
i
i
i
i
I
I
I
a
a
a
a
a
a
"}
(16,1,1) = {"
a
a
a
a
I
I
i
i
p
p
p
p
T
T
T
T
T
T
p
p
p
p
p
p
p
p
p
i
i
i
i
I
I
I
I
a
a
a
a
a
"}
(17,1,1) = {"
a
a
a
a
I
I
i
i
p
p
A
p
T
x
x
x
x
T
p
p
p
p
p
p
A
p
p
p
i
i
i
I
I
I
I
a
a
a
a
a
"}
(18,1,1) = {"
a
a
a
a
I
I
i
i
p
p
p
p
T
x
l
x
x
T
C
C
p
C
C
C
p
p
C
C
i
i
i
i
I
I
I
a
a
a
a
a
"}
(19,1,1) = {"
a
a
a
a
K
I
i
i
p
M
p
p
T
x
G
J
x
N
C
v
C
C
C
C
C
C
C
C
i
i
i
i
I
I
I
a
a
a
a
a
"}
(20,1,1) = {"
a
a
a
a
I
I
i
i
p
p
M
p
T
x
x
x
x
T
C
p
C
C
p
C
C
C
p
p
i
i
i
i
I
I
I
a
a
a
a
a
"}
(21,1,1) = {"
a
a
a
a
I
I
i
i
p
p
p
p
T
x
x
x
x
T
p
p
p
p
p
p
p
p
p
p
i
i
i
i
I
I
I
a
a
a
a
a
"}
(22,1,1) = {"
a
a
a
a
I
I
i
i
p
p
M
p
T
T
T
T
T
T
p
p
p
p
p
p
p
p
p
p
i
i
i
i
I
I
I
I
a
a
a
a
"}
(23,1,1) = {"
a
a
a
a
I
I
i
i
p
p
p
p
p
p
p
p
p
p
p
p
p
p
p
p
M
p
p
i
i
i
i
i
I
I
I
I
a
a
a
a
"}
(24,1,1) = {"
a
a
a
a
I
I
i
i
p
p
p
A
p
p
p
p
p
A
p
p
p
p
p
p
p
p
p
i
i
i
i
i
I
I
I
I
a
a
a
a
"}
(25,1,1) = {"
a
a
a
a
I
I
i
i
p
M
p
p
p
p
A
p
p
p
p
p
M
p
p
p
p
p
i
i
i
i
i
i
I
I
I
I
a
a
a
a
"}
(26,1,1) = {"
a
a
a
a
I
I
i
i
p
p
p
p
p
p
p
p
p
p
p
p
p
p
p
p
p
A
i
i
i
i
i
i
I
K
I
I
a
a
a
a
"}
(27,1,1) = {"
a
a
a
a
I
I
i
i
i
p
p
p
M
p
p
p
p
p
A
p
p
p
A
p
p
p
i
i
i
i
i
I
I
I
I
I
a
a
a
a
"}
(28,1,1) = {"
a
a
a
a
I
I
I
i
i
i
i
i
p
p
p
p
A
p
p
p
p
p
p
p
p
p
i
i
i
i
i
I
I
I
I
I
a
a
a
a
"}
(29,1,1) = {"
a
a
a
a
I
I
I
I
i
i
i
i
i
i
p
p
p
p
p
p
A
p
p
A
p
i
i
i
i
i
i
I
I
I
I
I
a
a
a
a
"}
(30,1,1) = {"
a
a
a
a
a
I
I
I
I
I
I
i
i
i
i
i
i
i
i
p
p
p
p
i
i
i
i
i
i
i
i
I
I
I
I
I
a
a
a
a
"}
(31,1,1) = {"
a
a
a
a
a
I
I
I
I
I
I
I
I
K
I
i
i
i
i
i
i
i
i
i
i
i
i
i
i
i
I
I
I
I
I
a
a
a
a
a
"}
(32,1,1) = {"
a
a
a
a
a
I
I
I
I
I
I
I
I
I
I
I
I
I
I
i
i
i
i
I
I
I
i
i
i
I
I
I
I
I
I
a
a
a
a
a
"}
(33,1,1) = {"
a
a
a
a
a
I
I
K
I
I
I
I
I
I
I
I
I
I
I
I
I
I
I
I
I
I
I
I
I
I
I
I
I
I
a
a
a
a
a
a
"}
(34,1,1) = {"
a
a
a
a
a
a
I
I
I
I
I
I
I
I
I
I
I
I
I
I
I
K
I
I
I
I
I
I
K
I
I
I
I
I
a
a
a
a
a
a
"}
(35,1,1) = {"
a
a
a
a
a
a
a
a
a
a
a
a
I
I
I
I
I
I
I
I
I
I
I
I
I
I
I
I
I
I
I
I
I
a
a
a
a
a
a
a
"}
(36,1,1) = {"
a
a
a
a
a
a
a
a
a
a
a
a
a
a
a
a
a
a
a
a
a
a
a
a
a
a
a
a
a
a
a
a
a
a
a
a
a
a
a
a
"}
(37,1,1) = {"
a
a
a
a
a
a
a
a
a
a
a
a
a
a
a
a
a
a
a
a
a
a
a
a
a
a
a
a
a
a
a
a
a
a
a
a
a
a
a
a
"}
(38,1,1) = {"
a
a
a
a
a
a
a
a
a
a
a
a
a
a
a
a
a
a
a
a
a
a
a
a
a
a
a
a
a
a
a
a
a
a
a
a
a
a
a
a
"}
(39,1,1) = {"
a
a
a
a
a
a
a
a
a
a
a
a
a
a
a
a
a
a
a
a
a
a
a
a
a
a
a
a
a
a
a
a
a
a
a
a
a
a
a
a
"}
(40,1,1) = {"
a
a
a
a
a
a
a
a
a
a
a
a
a
a
a
a
a
a
a
a
a
a
a
a
a
a
a
a
a
a
a
a
a
a
a
a
a
a
a
a
"}
