//MAP CONVERTED BY dmm2tgm.py THIS HEADER COMMENT PREVENTS RECONVERSION, DO NOT REMOVE
"aS" = (
/obj/structure/mineral_door/sandstone,
/obj/effect/turf_decal/sand,
/obj/effect/mine/stun,
/turf/open/misc/beach/sand,
/area/deathmatch/fullbright)
"cU" = (
/obj/structure/platform/sandstone,
/obj/item/gun/ballistic/automatic/m90/unrestricted{
	pixel_x = 2;
	pixel_y = -13
	},
/turf/open/misc/beach/sand,
/area/deathmatch/fullbright)
"ej" = (
/obj/structure/platform/sandstone,
/obj/item/gun/ballistic/shotgun/automatic/combat{
	pixel_x = 12;
	pixel_y = 2
	},
/turf/open/misc/beach/sand,
/area/deathmatch/fullbright)
"eV" = (
/obj/effect/turf_decal/sand,
/obj/item/grenade/syndieminibomb/concussion,
/turf/open/misc/beach/sand,
/area/deathmatch/fullbright)
"fz" = (
/obj/effect/powerup/health,
/turf/open/misc/beach/sand,
/area/deathmatch/fullbright)
"fJ" = (
/obj/structure/platform/sandstone,
/obj/item/gun/ballistic/shotgun/lethal,
/turf/open/misc/beach/sand,
/area/deathmatch/fullbright)
"gn" = (
/obj/structure/tram/alt/sandstone{
	name = "sandstone wall"
	},
/turf/open/misc/beach/sand,
/area/deathmatch/fullbright)
"ij" = (
/obj/structure/platform/sandstone,
/obj/item/gun/ballistic/automatic/c20r/unrestricted,
/turf/open/misc/beach/sand,
/area/deathmatch/fullbright)
"mo" = (
/obj/structure/billboard/roadsign/twomillion,
/turf/open/misc/beach/sand,
/area/deathmatch/fullbright)
"mE" = (
/obj/structure/platform/sandstone,
/obj/item/gun/ballistic/rifle/boltaction/surplus,
/turf/open/misc/beach/sand,
/area/deathmatch/fullbright)
"nn" = (
/obj/effect/turf_decal/sand/plating,
/obj/effect/turf_decal/weather/sand{
	dir = 8
	},
/turf/open/misc/beach/sand,
/area/deathmatch/fullbright)
"oA" = (
/obj/effect/spawner/random/cheburek_one_precent,
/turf/open/misc/beach/sand,
/area/deathmatch/fullbright)
"qk" = (
/obj/structure/platform/sandstone,
/obj/item/gun/ballistic/automatic/wt550{
	pixel_x = 15;
	pixel_y = 5
	},
/turf/open/misc/beach/sand,
/area/deathmatch/fullbright)
"qZ" = (
/obj/structure/platform/sandstone,
/obj/item/grenade/frag,
/turf/open/misc/beach/sand,
/area/deathmatch/fullbright)
"rt" = (
/obj/structure/platform/sandstone,
/obj/item/gun/ballistic/automatic/napad,
/turf/open/misc/beach/sand,
/area/deathmatch/fullbright)
"rU" = (
/obj/effect/turf_decal/sand,
/obj/structure/rack/skeletal,
/obj/item/gun/ballistic/shotgun/hook{
	pixel_x = 0;
	pixel_y = 4
	},
/turf/open/misc/beach/sand,
/area/deathmatch/fullbright)
"tH" = (
/obj/structure/platform/sandstone,
/obj/item/stack/sheet/mineral/sandstone/thirty{
	pixel_x = 0;
	pixel_y = 4
	},
/turf/open/misc/beach/sand,
/area/deathmatch/fullbright)
"zA" = (
/obj/machinery/deployable_turret/hmg{
	dir = 9
	},
/turf/open/misc/beach/sand,
/area/deathmatch/fullbright)
"zN" = (
/obj/effect/turf_decal/sand/plating,
/obj/effect/turf_decal/weather/sand{
	dir = 9
	},
/turf/open/misc/beach/sand,
/area/deathmatch/fullbright)
"zY" = (
/obj/effect/landmark/deathmatch_player_spawn,
/turf/open/misc/beach/sand,
/area/deathmatch/fullbright)
"Bn" = (
/obj/structure/platform/sandstone,
/obj/item/gun/grenadelauncher{
	pixel_x = 10;
	pixel_y = 0
	},
/turf/open/misc/beach/sand,
/area/deathmatch/fullbright)
"BQ" = (
/turf/open/misc/beach/sand,
/area/deathmatch/fullbright)
"Ce" = (
/turf/open/chasm/true/no_smooth/fake_motion_sand/fast,
/area/deathmatch/fullbright)
"Cf" = (
/obj/effect/turf_decal/sand/plating,
/obj/effect/turf_decal/weather/sand{
	dir = 4;
	pixel_x = 0;
	pixel_y = 0
	},
/turf/open/misc/beach/sand,
/area/deathmatch/fullbright)
"EC" = (
/obj/effect/turf_decal/sand/plating,
/obj/effect/turf_decal/weather/sand{
	dir = 5
	},
/turf/open/misc/beach/sand,
/area/deathmatch/fullbright)
"Gm" = (
/obj/structure/platform/sandstone,
/obj/item/gun/ballistic/revolver/mateba{
	pixel_x = -15;
	pixel_y = 4
	},
/turf/open/misc/beach/sand,
/area/deathmatch/fullbright)
"HC" = (
/obj/effect/turf_decal/sand/plating,
/turf/open/misc/beach/sand,
/area/deathmatch/fullbright)
"JJ" = (
/obj/effect/turf_decal/sand/plating,
/obj/effect/turf_decal/weather/sand{
	dir = 8;
	icon_state = "lightsand_side"
	},
/turf/open/misc/beach/sand,
/area/deathmatch/fullbright)
"KD" = (
/obj/structure/platform/sandstone,
/obj/item/gun/ballistic/automatic/battle_rifle,
/turf/open/misc/beach/sand,
/area/deathmatch/fullbright)
"Lb" = (
/obj/effect/mine/explosive/light,
/turf/open/misc/beach/sand,
/area/deathmatch/fullbright)
"Lo" = (
/obj/structure/platform/sandstone,
/turf/open/misc/beach/sand,
/area/deathmatch/fullbright)
"Mk" = (
/obj/effect/turf_decal/sand/plating,
/obj/effect/turf_decal/weather/sand{
	dir = 10
	},
/turf/open/misc/beach/sand,
/area/deathmatch/fullbright)
"Og" = (
/obj/effect/turf_decal/sand,
/turf/open/misc/beach/sand,
/area/deathmatch/fullbright)
"Oy" = (
/obj/effect/turf_decal/sand/plating,
/obj/effect/turf_decal/weather/sand{
	dir = 4
	},
/turf/open/misc/beach/sand,
/area/deathmatch/fullbright)
"OD" = (
/obj/effect/turf_decal/sand/plating,
/obj/effect/turf_decal/weather/sand{
	dir = 6
	},
/turf/open/misc/beach/sand,
/area/deathmatch/fullbright)
"OH" = (
/obj/structure/platform/sandstone,
/obj/item/stack/sheet/mineral/sandbags/fifty{
	pixel_x = 0;
	pixel_y = 7
	},
/turf/open/misc/beach/sand,
/area/deathmatch/fullbright)
"OL" = (
/obj/structure/platform/sandstone,
/obj/item/gun/ballistic/automatic/l6_saw/unrestricted,
/turf/open/misc/beach/sand,
/area/deathmatch/fullbright)
"RG" = (
/obj/structure/barricade/sandbags,
/turf/open/misc/beach/sand,
/area/deathmatch/fullbright)
"Ss" = (
/obj/effect/turf_decal/sand,
/obj/structure/rack/skeletal{
	pixel_x = 0;
	pixel_y = 0
	},
/obj/item/claymore/cutlass{
	pixel_x = 2;
	pixel_y = 7
	},
/turf/open/misc/beach/sand,
/area/deathmatch/fullbright)
"Tn" = (
/obj/effect/powerup/ammo,
/turf/open/misc/beach/sand,
/area/deathmatch/fullbright)
"TA" = (
/obj/effect/turf_decal/sand,
/obj/item/stack/sheet/mineral/sandbags/fifty,
/obj/item/stack/sheet/mineral/sandstone/thirty,
/turf/open/misc/beach/sand,
/area/deathmatch/fullbright)
"WL" = (
/obj/structure/platform/sandstone,
/obj/item/grenade/chem_grenade/incendiary{
	pixel_x = 5;
	pixel_y = 0
	},
/obj/item/grenade/chem_grenade/incendiary{
	pixel_x = 13;
	pixel_y = 0
	},
/obj/item/grenade/chem_grenade/incendiary{
	pixel_x = 9;
	pixel_y = 10
	},
/turf/open/misc/beach/sand,
/area/deathmatch/fullbright)
"WS" = (
/obj/structure/platform/sandstone,
/obj/item/gun/ballistic/automatic/lahti{
	pixel_x = 11;
	pixel_y = 0
	},
/turf/open/misc/beach/sand,
/area/deathmatch/fullbright)

(1,1,1) = {"
Ce
Ce
Ce
Ce
Ce
Ce
Ce
Ce
Ce
Ce
Ce
Ce
Ce
Ce
Ce
Ce
Ce
Ce
Ce
Ce
Ce
Ce
Ce
Ce
Ce
Ce
Ce
Ce
Ce
Ce
"}
(2,1,1) = {"
Ce
BQ
BQ
BQ
BQ
BQ
BQ
BQ
BQ
BQ
BQ
BQ
Lb
BQ
BQ
ij
Lo
BQ
BQ
BQ
BQ
BQ
BQ
BQ
BQ
BQ
BQ
BQ
BQ
Ce
"}
(3,1,1) = {"
Ce
WS
Lo
Lo
BQ
BQ
BQ
Lo
BQ
BQ
fz
BQ
BQ
BQ
BQ
BQ
BQ
BQ
BQ
BQ
BQ
BQ
BQ
BQ
BQ
BQ
BQ
BQ
BQ
Ce
"}
(4,1,1) = {"
Ce
Lo
zY
BQ
BQ
BQ
BQ
tH
BQ
BQ
Lo
BQ
BQ
Lo
zY
BQ
BQ
BQ
BQ
qZ
BQ
Lo
qk
fz
BQ
BQ
BQ
BQ
BQ
Ce
"}
(5,1,1) = {"
Ce
Lo
BQ
BQ
OH
Lo
BQ
Lo
BQ
BQ
OL
BQ
BQ
tH
BQ
BQ
Lo
BQ
BQ
OH
BQ
BQ
Lo
Lo
BQ
BQ
BQ
BQ
BQ
Ce
"}
(6,1,1) = {"
Ce
BQ
BQ
BQ
BQ
BQ
BQ
Tn
BQ
BQ
BQ
BQ
BQ
BQ
BQ
BQ
rt
zY
BQ
BQ
BQ
BQ
zY
BQ
BQ
BQ
BQ
BQ
BQ
Ce
"}
(7,1,1) = {"
Ce
BQ
BQ
BQ
BQ
BQ
BQ
BQ
BQ
BQ
BQ
BQ
BQ
BQ
BQ
BQ
Lo
Lo
BQ
BQ
WL
BQ
BQ
BQ
Lo
BQ
BQ
BQ
BQ
Ce
"}
(8,1,1) = {"
Ce
BQ
BQ
Lo
fJ
BQ
BQ
BQ
Lo
BQ
qZ
Lo
BQ
BQ
Lo
BQ
Tn
tH
BQ
BQ
Bn
BQ
Tn
BQ
Gm
BQ
BQ
BQ
BQ
Ce
"}
(9,1,1) = {"
Ce
BQ
BQ
BQ
BQ
BQ
BQ
BQ
KD
zY
BQ
BQ
BQ
BQ
mE
BQ
BQ
Lo
BQ
BQ
Lo
BQ
ej
BQ
OH
BQ
BQ
BQ
BQ
Ce
"}
(10,1,1) = {"
Ce
BQ
BQ
BQ
BQ
BQ
BQ
BQ
BQ
BQ
BQ
OH
zY
BQ
Lo
BQ
BQ
BQ
BQ
BQ
BQ
BQ
Lo
BQ
BQ
BQ
BQ
BQ
BQ
Ce
"}
(11,1,1) = {"
Ce
BQ
BQ
BQ
Tn
Lo
OH
BQ
BQ
BQ
BQ
Lo
BQ
BQ
BQ
BQ
BQ
BQ
BQ
BQ
BQ
BQ
BQ
BQ
BQ
BQ
BQ
BQ
BQ
Ce
"}
(12,1,1) = {"
Ce
BQ
BQ
BQ
BQ
BQ
BQ
BQ
Lo
Lo
BQ
BQ
BQ
BQ
BQ
BQ
BQ
BQ
BQ
BQ
tH
Lo
BQ
BQ
BQ
Lb
BQ
BQ
BQ
Ce
"}
(13,1,1) = {"
Ce
BQ
BQ
BQ
Lb
BQ
BQ
BQ
BQ
Tn
BQ
BQ
BQ
cU
Lo
BQ
BQ
Lb
BQ
BQ
BQ
BQ
BQ
BQ
BQ
BQ
BQ
BQ
BQ
Ce
"}
(14,1,1) = {"
Ce
BQ
zN
Mk
BQ
BQ
BQ
BQ
BQ
BQ
BQ
BQ
BQ
BQ
BQ
BQ
BQ
BQ
BQ
BQ
BQ
BQ
BQ
BQ
BQ
BQ
BQ
BQ
BQ
Ce
"}
(15,1,1) = {"
Ce
nn
HC
HC
nn
nn
Mk
BQ
BQ
zN
nn
nn
Mk
BQ
BQ
BQ
zN
nn
nn
Mk
BQ
BQ
BQ
BQ
zN
JJ
JJ
JJ
JJ
Ce
"}
(16,1,1) = {"
Ce
HC
HC
HC
HC
HC
HC
nn
nn
HC
HC
HC
HC
nn
nn
nn
HC
HC
HC
HC
JJ
JJ
JJ
JJ
HC
HC
HC
HC
HC
Ce
"}
(17,1,1) = {"
Ce
HC
HC
Oy
HC
HC
HC
HC
HC
HC
HC
HC
HC
HC
HC
HC
HC
HC
HC
HC
HC
HC
HC
HC
HC
HC
HC
HC
HC
Ce
"}
(18,1,1) = {"
Ce
HC
OD
BQ
EC
Oy
HC
HC
HC
HC
HC
Cf
Oy
HC
HC
HC
Oy
Oy
Oy
Oy
Oy
HC
HC
HC
HC
HC
Oy
Oy
HC
Ce
"}
(19,1,1) = {"
Ce
OD
BQ
BQ
BQ
BQ
EC
Oy
Oy
Oy
OD
BQ
BQ
EC
Oy
OD
BQ
BQ
BQ
BQ
BQ
EC
Oy
Oy
Oy
OD
BQ
BQ
EC
Ce
"}
(20,1,1) = {"
Ce
BQ
BQ
BQ
BQ
BQ
BQ
BQ
BQ
BQ
BQ
BQ
BQ
BQ
BQ
BQ
BQ
BQ
BQ
BQ
BQ
BQ
BQ
BQ
BQ
BQ
BQ
BQ
BQ
Ce
"}
(21,1,1) = {"
Ce
BQ
BQ
BQ
BQ
oA
BQ
mo
BQ
BQ
Lb
BQ
BQ
BQ
BQ
BQ
BQ
RG
RG
BQ
BQ
RG
RG
BQ
Lb
RG
RG
RG
BQ
Ce
"}
(22,1,1) = {"
Ce
BQ
BQ
BQ
BQ
BQ
BQ
BQ
BQ
BQ
BQ
BQ
BQ
BQ
BQ
BQ
BQ
BQ
BQ
BQ
BQ
BQ
BQ
BQ
BQ
RG
zA
RG
BQ
Ce
"}
(23,1,1) = {"
Ce
BQ
BQ
BQ
BQ
BQ
BQ
BQ
BQ
BQ
BQ
BQ
RG
RG
RG
BQ
RG
RG
RG
RG
RG
RG
RG
RG
BQ
BQ
zY
BQ
BQ
Ce
"}
(24,1,1) = {"
Ce
BQ
BQ
BQ
BQ
BQ
BQ
BQ
BQ
RG
RG
BQ
BQ
Tn
RG
BQ
RG
BQ
BQ
BQ
BQ
BQ
BQ
RG
RG
RG
BQ
BQ
BQ
Ce
"}
(25,1,1) = {"
Ce
BQ
BQ
RG
RG
BQ
RG
BQ
RG
RG
BQ
BQ
zY
BQ
BQ
BQ
RG
BQ
gn
gn
gn
gn
BQ
BQ
BQ
RG
BQ
BQ
BQ
Ce
"}
(26,1,1) = {"
Ce
BQ
RG
RG
BQ
BQ
RG
BQ
BQ
BQ
BQ
RG
RG
RG
RG
BQ
BQ
BQ
gn
TA
TA
gn
gn
gn
BQ
RG
BQ
BQ
BQ
Ce
"}
(27,1,1) = {"
Ce
BQ
BQ
BQ
BQ
RG
RG
BQ
RG
BQ
BQ
BQ
RG
fz
BQ
BQ
RG
BQ
aS
Og
Og
Og
rU
gn
BQ
RG
BQ
BQ
BQ
Ce
"}
(28,1,1) = {"
Ce
BQ
RG
RG
BQ
BQ
BQ
BQ
RG
RG
RG
BQ
RG
BQ
RG
BQ
RG
BQ
gn
eV
Og
Og
Ss
gn
BQ
RG
BQ
BQ
BQ
Ce
"}
(29,1,1) = {"
Ce
BQ
fz
RG
BQ
RG
RG
RG
RG
Tn
BQ
BQ
BQ
BQ
BQ
BQ
RG
RG
gn
gn
gn
gn
gn
gn
RG
RG
BQ
BQ
BQ
Ce
"}
(30,1,1) = {"
Ce
Ce
Ce
Ce
Ce
Ce
Ce
Ce
Ce
Ce
Ce
Ce
Ce
Ce
Ce
Ce
Ce
Ce
Ce
Ce
Ce
Ce
Ce
Ce
Ce
Ce
Ce
Ce
Ce
Ce
"}
